{
    "bottomTiles" : [ [1, 1, 1, 1, 0, 1, 1, 1, 1 ],
                     [1, 1, 1, 1, 0, 1, 1, 1, 1 ],
                     [1, 1, 1, 1, 1, 1, 1, 1, 1 ],
                     [1, 1, 1, 1, 1, 1, 1, 1, 1 ],
                     [0, 0, 1, 1, 0, 1, 1, 0, 0 ],
                     [1, 1, 1, 1, 1, 1, 1, 1, 1 ],
                     [1, 1, 1, 1, 1, 1, 1, 1, 1 ],
                     [2, 3, 2, 3, 0, 3, 2, 3, 2 ],
                     [2, 2, 2, 2, 0, 2, 2, 2, 2 ] ],
    
    "topObstacles": [ [0, 0, 0, 0, 0, 0, 0, 0, 0 ],
                     [0, 0, 0, 0, 0, 0, 0, 0, 0 ],
                     [0, 0, 0, 0, 0, 0, 0, 0, 0 ],
                     [0, 0, 0, 0, 0, 0, 0, 0, 0 ],
                     [0, 0, 0, 0, 0, 0, 0, 0, 0 ],
                     [0, 0, 0, 0, 0, 0, 0, 0, 0 ],
                     [0, 0, 0, 0, 0, 0, 0, 0, 0 ],
                     [0, 0, 0, 0, 0, 0, 0, 0, 0 ],
                     [1, 1, 1, 1, 0, 2, 2, 2, 2 ] ],

    "targetScore" : 1000,
    "moves" : 30,
    "orderData" : [
                    {
                   "type" : "obstacle",
                   "id" : "Gold Plated Tile",
                   "quantity" : 20
                    },
                   
                   {
                   "type" : "obstacle",
                   "id" : "Wad Of Cash One",
                   "quantity" : 12
                   },
                   
                   {
                   "type" : "cookie",
                   "id" : 3,
                   "quantity" : 15
                   },
    ],
}
