{
  "tiles" : [ [5, 5, 5, 5, 5, 5, 5, 5, 5 ],
              [5, 2, 2, 1, 1, 1, 2, 2, 5 ],
              [5, 2, 1, 1, 1, 1, 1, 2, 5 ],
              [5, 1, 1, 1, 1, 1, 1, 1, 5 ],
              [5, 1, 1, 1, 1, 1, 1, 1, 5 ],
              [5, 1, 1, 1, 1, 1, 1, 1, 5 ],
              [5, 2, 1, 1, 1, 1, 1, 2, 5 ],
              [5, 2, 2, 1, 1, 1, 2, 2, 5 ],
              [5, 5, 5, 5, 5, 5, 5, 5, 5 ] ],

  "targetScore" : 1000,
  "moves" : 50,
  "orderCookieType" : [1, 2, 3, 4],
  "orderCookieQuantity" : [5, 4, 2, 1],

}
