{
    "tiles" : [ [0, 1, 1, 0, 0, 0, 1, 1, 0 ],
              [1, 1, 1, 1, 1, 1, 1, 1, 1 ],
              [1, 1, 1, 1, 1, 1, 1, 1, 1 ],
              [1, 1, 1, 1, 1, 1, 1, 1, 1 ],
              [0, 0, 1, 1, 2, 2, 1, 0, 0 ],
              [1, 1, 1, 1, 2, 2, 1, 1, 1 ],
              [1, 1, 1, 1, 1, 1, 1, 1, 1 ],
              [1, 1, 1, 1, 1, 1, 1, 1, 1 ],
              [0, 1, 1, 2, 2, 2, 1, 1, 0 ] ],

    "targetScore" : 1000,
    "moves" : 17,
    "orderCookieType" : [1],
    "orderCookieQuantity" : [1],
}
