{
  "tiles" : [ [1, 1, 0, 0, 1, 0, 0, 1, 1 ],
              [1, 0, 0, 1, 1, 1, 0, 0, 1 ],
              [0, 0, 1, 1, 1, 1, 1, 0, 0 ],
              [0, 1, 1, 1, 0, 1, 1, 1, 0 ],
              [1, 1, 1, 2, 2, 2, 1, 1, 1 ],
              [0, 1, 1, 1, 0, 1, 1, 1, 0 ],
              [0, 0, 1, 1, 1, 1, 1, 0, 0 ],
              [1, 0, 0, 1, 1, 1, 0, 0, 1 ],
              [1, 1, 0, 0, 1, 0, 0, 1, 1 ] ],

  "targetScore" : 1000,
  "moves" : 20,
  "orderCookieType" : [1, 3, 4, 6],
  "orderCookieQuantity" : [6, 9, 1, 1],
}
