{
  "tiles" : [ [0, 0, 1, 0, 0, 0, 1, 0, 0 ],
              [0, 1, 1, 1, 0, 1, 1, 1, 0 ],
              [1, 1, 1, 1, 1, 1, 1, 1, 1 ],
              [1, 1, 1, 1, 0, 1, 1, 1, 1 ],
              [1, 1, 1, 1, 0, 1, 1, 1, 1 ],
              [0, 1, 1, 1, 1, 1, 1, 1, 0 ],
              [0, 0, 1, 1, 1, 1, 1, 0, 0 ],
              [0, 0, 0, 1, 1, 1, 0, 0, 0 ],
              [0, 0, 0, 0, 1, 0, 0, 0, 0 ] ],

  "targetScore" : 1000,
  "moves" : 30,
  "orderCookieType" : [1, 2, 3, 4],
  "orderCookieQuantity" : [5, 4, 2, 1],

}
