{
    "tiles" : [ [1, 1, 1, 0, 0, 0, 1, 1, 0 ],
              [1, 1, 1, 1, 1, 1, 1, 1, 1 ],
              [1, 1, 1, 1, 1, 1, 1, 1, 1 ],
              [1, 1, 1, 1, 1, 1, 1, 1, 1 ],
              [1, 1, 1, 1, 2, 2, 1, 0, 0 ],
              [1, 1, 1, 1, 2, 2, 1, 1, 1 ],
              [1, 1, 1, 1, 1, 1, 1, 1, 1 ],
              [1, 1, 1, 1, 1, 1, 1, 1, 1 ],
              [1, 1, 1, 2, 2, 2, 1, 1, 0 ] ],

    "targetScore" : 1000,
    "moves" : 50,
    "orderCookieType" : [1, 2, 4],
    "orderCookieQuantity" : [1, 5, 3],
}
