{
    "bottomTiles" : [ [3, 3, 3, 3, 0, 3, 3, 3, 3 ],
              [1, 1, 1, 2, 0, 2, 1, 1, 1 ],
              [1, 1, 1, 2, 1, 2, 1, 1, 1 ],
              [1, 1, 1, 2, 1, 2, 1, 1, 1 ],
              [0, 0, 1, 2, 0, 2, 1, 0, 0 ],
              [1, 1, 1, 2, 1, 2, 1, 1, 1 ],
              [1, 1, 1, 2, 1, 2, 1, 1, 1 ],
              [1, 1, 1, 2, 0, 2, 1, 1, 1 ],
              [1, 1, 1, 2, 0, 2, 1, 1, 1 ] ],
    
    "topObstacles": [ [1, 1, 1, 0, 0, 0, 0, 0, 0 ],
                     [0, 0, 0, 0, 0, 0, 0, 0, 0 ],
                     [0, 0, 0, 0, 0, 0, 0, 0, 0 ],
                     [0, 0, 0, 0, 0, 0, 0, 0, 0 ],
                     [0, 0, 0, 0, 0, 0, 0, 0, 0 ],
                     [0, 0, 0, 0, 0, 0, 0, 0, 0 ],
                     [0, 0, 0, 0, 0, 0, 0, 0, 0 ],
                     [0, 0, 0, 0, 0, 0, 0, 0, 0 ],
                     [0, 0, 0, 0, 0, 0, 0, 0, 0 ] ],

    "targetScore" : 1000,
    "moves" : 15,
    "orderCookieType" : [1, 2, 3, 4],
    "orderCookieQuantity" : [20, 20, 20, 20],
    "orderData" : [
                    {
                   "type" : "obstacle",
                   "id" : "Gold Plated Tile",
                   "quantity" : 10
                    },
                   
                   {
                   "type" : "cookie",
                   "id" : 3,
                   "quantity" : 15
                   },
    ],
}
