{
    "bottomTiles" : [ [1, 1, 1, 1, 0, 1, 1, 1, 1 ],
                     [1, 1, 1, 1, 0, 1, 1, 1, 1 ],
                     [1, 1, 1, 1, 1, 1, 1, 1, 1 ],
                     [1, 1, 1, 1, 1, 1, 1, 1, 1 ],
                     [0, 0, 1, 1, 0, 1, 1, 0, 0 ],
                     [1, 1, 1, 1, 1, 1, 1, 1, 1 ],
                     [1, 1, 1, 1, 1, 1, 1, 1, 1 ],
                     [1, 1, 1, 1, 0, 1, 1, 1, 1 ],
                     [1, 1, 1, 1, 0, 1, 1, 1, 1 ] ],
    
    "topObstacles" : [ [0, 2, 1, 0, 0, 0, 0, 0, 0 ],
                     [0, 0, 0, 0, 0, 0, 0, 0, 0 ],
                     [0, 0, 0, 0, 0, 0, 0, 0, 0 ],
                     [0, 0, 0, 0, 0, 0, 0, 0, 0 ],
                     [0, 0, 0, 0, 0, 0, 0, 0, 0 ],
                     [0, 0, 0, 0, 0, 0, 0, 0, 0 ],
                     [1, 1, 1, 1, 1, 1, 1, 1, 1 ],
                     [0, 0, 0, 0, 0, 0, 0, 0, 0 ],
                     [0, 0, 0, 0, 0, 0, 0, 0, 0 ] ],
    
    "cookies" : [ [1, 1, 1, 1, 1, 1, 1, 1, 1 ],
                [1, 1, 1, 1, 1, 1, 1, 1, 1 ],
                [1, 1, 1, 1, 1, 1, 1, 1, 1 ],
                [1, 1, 1, 1, 1, 1, 1, 1, 1 ],
                [1, 1, 1, 1, 1, 1, 1, 1, 1 ],
                [1, 1, 1, 1, 1, 1, 1, 1, 1 ],
                [0, 0, 0, 0, 0, 0, 0, 0, 0 ],
                [0, 0, 0, 0, 0, 0, 0, 0, 0 ],
                [0, 0, 0, 0, 0, 0, 0, 0, 0 ] ],

    "targetScore" : 1000,
    "moves" : 30,
    "orderData" : [
                    {
                   "type" : "obstacle",
                   "id" : "Gold Plated Tile",
                   "quantity" : 20
                    },
                   
                   {
                   "type" : "obstacle",
                   "id" : "Wad Of Cash One",
                   "quantity" : 12
                   },
                   
                   {
                   "type" : "cookie",
                   "id" : 3,
                   "quantity" : 15
                   },
    ],
}
