{
    "tiles" : [ [0, 1, 1, 0, 0, 0, 1, 1, 0 ],
              [1, 1, 1, 1, 1, 1, 1, 1, 1 ],
              [1, 1, 1, 1, 1, 1, 1, 1, 1 ],
              [1, 1, 1, 1, 1, 1, 1, 1, 1 ],
              [0, 0, 1, 1, 2, 2, 1, 0, 0 ],
              [1, 1, 1, 1, 2, 2, 1, 1, 1 ],
              [1, 1, 1, 1, 1, 1, 1, 1, 1 ],
              [1, 1, 1, 1, 1, 1, 1, 1, 1 ],
              [0, 1, 1, 0, 0, 0, 1, 1, 0 ] ],

    "targetScore" : 1000,
    "moves" : 15,
    "orderCookieType" : [1, 3, 4, 6],
    "orderCookieQuantity" : [5, 4, 2, 1],    
}
