{
    "tiles" : [ [2, 2, 1, 0, 0, 0, 1, 1, 0 ],
              [2, 2, 1, 1, 1, 1, 1, 1, 1 ],
              [2, 2, 1, 2, 1, 1, 1, 1, 1 ],
              [2, 2, 2, 2, 1, 1, 1, 1, 1 ],
              [2, 2, 1, 2, 1, 1, 1, 0, 0 ],
              [2, 2, 2, 2, 1, 1, 1, 1, 1 ],
              [2, 2, 1, 1, 1, 1, 1, 1, 7 ],
              [2, 2, 1, 1, 1, 1, 1, 1, 8 ],
              [2, 2, 1, 1, 1, 1, 1, 1, 0 ] ],

    "targetScore" : 1000,
    "moves" : 50,
}
