{
    "tiles" : [ [1, 1, 1, 1, 0, 1, 1, 1, 1 ],
              [1, 1, 3, 1, 0, 1, 1, 1, 1 ],
              [1, 1, 1, 1, 1, 1, 1, 1, 1 ],
              [1, 1, 1, 1, 1, 1, 1, 1, 1 ],
              [0, 0, 1, 1, 0, 1, 1, 0, 0 ],
              [1, 1, 1, 1, 1, 1, 1, 1, 1 ],
              [1, 1, 1, 1, 1, 1, 1, 1, 1 ],
              [1, 1, 1, 1, 0, 1, 1, 1, 1 ],
              [1, 1, 1, 1, 0, 1, 1, 1, 1 ] ],

    "targetScore" : 1000,
    "moves" : 15,
    "securityGuardCountdown" : 10,
    "orderCookieType" : [1, 2, 3, 4],
    "orderCookieQuantity" : [20, 20, 20, 20],
}
