{
  "tiles" : [ [5, 5, 5, 1, 0, 1, 5, 5, 5 ],
              [4, 0, 0, 1, 1, 1, 0, 0, 4 ],
              [0, 0, 1, 1, 1, 1, 1, 0, 0 ],
              [0, 1, 1, 1, 0, 1, 1, 1, 0 ],
              [0, 1, 1, 1, 1, 1, 1, 1, 0 ],
              [0, 1, 1, 1, 0, 1, 1, 1, 0 ],
              [0, 0, 1, 1, 1, 1, 1, 0, 0 ],
              [4, 0, 0, 1, 1, 1, 0, 0, 4 ],
              [5, 5, 5, 1, 0, 1, 5, 5, 5 ] ],

  "targetScore" : 1000,
  "moves" : 100,
}
