{
    "bottomTiles" : [ [1, 1, 1, 1, 0, 1, 1, 1, 1 ],
                     [1, 1, 1, 1, 0, 1, 1, 1, 1 ],
                     [1, 1, 1, 1, 1, 1, 1, 1, 1 ],
                     [1, 1, 1, 1, 1, 1, 1, 1, 1 ],
                     [1, 1, 1, 1, 0, 1, 1, 0, 0 ],
                     [1, 1, 1, 1, 1, 1, 1, 1, 1 ],
                     [1, 1, 1, 1, 1, 1, 1, 1, 1 ],
                     [1, 1, 1, 2, 0, 2, 2, 2, 2 ],
                     [3, 3, 3, 3, 0, 3, 3, 3, 3 ] ],
    
    "topObstacles": [ [0, 0, 0, 0, 0, 0, 0, 0, 0 ],
                     [0, 0, 0, 0, 0, 0, 0, 0, 0 ],
                     [0, 0, 0, 0, 0, 0, 0, 0, 0 ],
                     [3, 3, 3, 1, 1, 1, 1, 1, 1 ],
                     [0, 0, 0, 0, 0, 0, 0, 0, 0 ],
                     [0, 0, 0, 0, 0, 0, 0, 0, 0 ],
                     [3, 3, 0, 0, 0, 0, 0, 0, 0 ],
                     [0, 0, 0, 0, 0, 0, 0, 0, 0 ],
                     [0, 0, 0, 0, 0, 0, 0, 0, 0 ] ],
    
    "cookies" : [ [1, 1, 1, 1, 1, 1, 1, 1, 1 ],
                 [1, 1, 1, 1, 1, 1, 1, 1, 1 ],
                 [1, 1, 1, 1, 1, 1, 1, 1, 1 ],
                 [1, 1, 1, 1, 1, 1, 1, 1, 1 ],
                 [1, 1, 1, 1, 1, 1, 1, 1, 1 ],
                 [0, 1, 1, 1, 1, 1, 1, 1, 1 ],
                 [1, 1, 1, 1, 1, 1, 1, 1, 1 ],
                 [1, 1, 1, 1, 1, 1, 1, 1, 1 ],
                 [0, 1, 1, 1, 1, 1, 1, 1, 1 ] ],
    
    "targetScore" : 1000,
    "moves" : 20,
    "orderData" : [
                   {
                   "type" : "obstacle",
                   "id" : "Gold Plated Tile",
                   "quantity" : 24
                   },
                   
                   {
                   "type" : "cookie",
                   "id" : 3,
                   "quantity" : 10
                   },
                   
                   {
                   "type" : "cookie",
                   "id" : 2,
                   "quantity" : 10
                   },
                   
                   ],
}

